WWWWWWWWWWWWW
W:..W...W...W
W.@.D.&.E.F.W
W...W:..W...W
WWWWWWWWWWWWW
