WWWWW
W.&.W
W.@.W
W:..W
WW&WW
W...W
W..FW
W:..W
WWWWW
