WWWWWWWWWWWWWWWWWWWWWWWWWWWWWWWWWWWWWWWWWWWWWWWWWWWWWWWWWWWWWWWWWWWWWWWWWWWWWWWWWWWWWWWWWWWWWWWWWWWWWWWWWWWWWWWWWWWWWWWWWWWWWWWWWWWWWWWWWWWWWWWWWWWWWWWWWWWWWWWWWWWWWWWWWWWWWWWWWWWWWWWWWWWWWWWWWWWWWWWWWWWWW
W...W...W...W...W...W...W...W...W...W...W...W...W...W...W...W...W...W...W...W...W...W...W...W...W...W...W...W...W...W...W...W...W...W...W...W...W...W...W...W...W...W...W...W...W...W...W...W...W...W...W...W
W...W...W...W...W...W...W...W...W...W...W...W...W...W...W...W...W...W...W...W...W...W...W...W...W...W...W...W...W...W...W...W...W...W...W...W...W...W...W...W...W...W...W...W...W...W...W...W...W...W...W...W
W...W...W...W...W...W...W...W...W...W...W...W...W...W...W...W...W...W...W...W...W...W...W...W...W...W...W...W...W...W...W...W...W...W...W...W...W...W...W...W...W...W...W...W...W...W...W...W...W...W...W...W
WWWWWWWWWWWWWWWWWWWWWWWWWWWWWWWWWWWWWWWWWWWWWWWWWWWWWWWWWWWWWWWWWWWWWWWWWWWWWWWWWWWWWWWWWWWWWWWWWWWWWWWWWWWWWWWWWWWWWWWWWWWWWWWWWWWWWWWWWWWWWWWWWWWWWWWWWWWWWWWWWWWWWWWWWWWWWWWWWWWWWWWWWWWWWWWWWWWWWWWWWWWWW
W...W...W...W...W...W...W...W...W...W...W...W...W...W...W...W...W...W...W...W...W...W...W...W...W...W...W...W...W...W...W...W...W...W...W...W...W...W...W...W...W...W...W...W...W...W...W...W...W...W...W...W
W...W...W...W...W...W...W...W...W...W...W...W...W...W...W...W...W...W...W...W...W...W...W...W...W...W...D...D...W...W...W...W...W...W...W...W...W...W...W...W...W...W...W...W...W...W...W...W...W...W...W...W
W...W...W...W...W...W...W...W...W...W...W...W...W...W...W...W...W...W...W...W...W...W...W...W...W...W...W...W...W...W...W...W...W...W...W...W...W...W...W...W...W...W...W...W...W...W...W...W...W...W...W...W
WWWWWWWWWWWWWWWWWWWWWWWWWWWWWWWWWWWWWWWWWWWWWWWWWWWWWWWWWWWWWWWWWWWWWWWWWWWWWWWWWWWWWWWWWWWWWWWWWWWWWWDWWWWWWWDWWWWWWWWWWWWWWWWWWWWWWWWWWWWWWWWWWWWWWWWWWWWWWWWWWWWWWWWWWWWWWWWWWWWWWWWWWWWWWWWWWWWWWWWWWWWWW
W...W...W...W...W...W...W...W...W...W...W...W...W...W...W...W...W...W...W...W...W...W...W...W...W...W...W...W...W...W...W...W...W...W...W...W...W...W...W...W...W...W...W...W...W...W...W...W...W...W...W...W
W...W...W...W...W...W...W...W...W...W...W...W...W...W...W...W...W...W...W...W...W...W...W...W...W...W...W...W...D...D...D...W...W...W...W...W...W...W...W...W...W...W...W...W...W...W...W...W...W...W...W...W
W...W...W...W...W...W...W...W...W...W...W...W...W...W...W...W...W...W...W...W...W...W...W...W...W...W...W...W...W...W...W...W...W...W...W...W...W...W...W...W...W...W...W...W...W...W...W...W...W...W...W...W
WWWWWWWWWWWWWWWWWWWWWWWWWWWWWWWWWWWWWWWWWWWWWWWWWWWWWWWWWWWWWWWWWWWWWWWWWWWWWWWWWWWWWWWWWWWWWWWWWWWWWWDWWWWWWWWWWWWWWWWWWWDWWWWWWWWWWWWWWWWWWWWWWWWWWWWWWWWWWWWWWWWWWWWWWWWWWWWWWWWWWWWWWWWWWWWWWWWWWWWWWWWWW
W...W...W...W...W...W...W...W...W...W...W...W...W...W...W...W...W...W...W...W...W...W...W...W.......W...W...W...W...W...W...W...W...W...W...W...W...W...W...W...W...W...W...W...W...W...W...W...W...W...W...W
W...W...W...W...W...W...W...W...W...W...W...W...W...W...W...W...W...W...W...W...W...W...W...W.:...~.W...W...W...W...W...W...W...W...W...W...W...W...W...W...W...W...W...W...W...W...W...W...W...W...W...W...W
W...W...W...W...W...W...W...W...W...W...W...W...W...W...W...W...W...W...W...W...W...W...W...W.......W...W...W...W...W...W...W...W...W...W...W...W...W...W...W...W...W...W...W...W...W...W...W...W...W...W...W
WWWWWWWWWWWWWWWWWWWWWWWWWWWWWWWWWWWWWWWWWWWWWWWWWWWWWWWWWWWWWWWWWWWWWWWWWWWWWWWWWWWWWWWWWWWWWWWWW...WWDWWWWWWWWWWWWWWWWWWWDWWWWWWWWWWWWWWWWWWWWWWWWWWWWWWWWWWWWWWWWWWWWWWWWWWWWWWWWWWWWWWWWWWWWWWWWWWWWWWWWWW
W...W...W...W...W...W...W...W...W...W...W...W...W...W...W...W...W...W...W...W...W...W...W...W...W...W...W...W...W...W...W...W...W...W...W...W...W...W...W...W...W...W...W...W...W...W...W...W...W...W...W...W
W...W...W...W...W...W...W...W...W...W...W...W...W...W...W...W...W...W...W...W...W...D...D...D...W...W...W...W...W...W...W...W...W...W...W...W...W...W...W...W...W...W...W...W...W...W...W...W...W...W...W...W
W...W...W...W...W...W...W...W...W...W...W...W...W...W...W...W...W...W...W...W...W...W.$.W.$.W.$.W...W...W...W...W...W...W...W...W...W...W...W...W...W...W...W...W...W...W...W...W...W...W...W...W...W...W...W
WWWWWWWWWWWWWWWWWWWWWWWWWWWWWWWWWWWWWWWWWWWWWWWWWWWWWWWWWWWWWWWWWWWWWWWWWWWWWWWWWWDWWWWWWWWWWWWWWWDWWWDWWWDWWWWWWWWWWWWWWWDWWWWWWWWWWWWWWWWWWWWWWWWWWWWWWWWWWWWWWWWWWWWWWWWWWWWWWWWWWWWWWWWWWWWWWWWWWWWWWWWWW
W~~~.~~~W...W...W...W...W...W...W...W...W...W...W...W...W...W...W...W...W...W...W...W...W...W...W...W...W...W...W...W...W...W...W...W...W...W...W...W...W...W...W...W...W...W...W...W...W...W...W...W...W...W
W~~~.~~~W...W...W...W...W...W...W...W...W...W...W...W...W...W...W...W...W...W...D...W.~.W...D...D...W...W...W...W...W...W...W...W...W...W...W...W...W...W...W...W...W...W...W...W...W...W...W...W...W...W...W
W~~~.~~~W...W...W...W...W...W...W...W...W...W...W...W...W...W...W...W...W...W...W...W...W...W...W...W...W...W...W...W...W...W...W...W...W...W...W...W...W...W...W...W...W...W...W...W...W...W...W...W...W...W
W.......WWWWWWWWWWWWWWWWWWWWWWWWWWWWWWWWWWWWWWWWWWWWWWWWWWWWWWWWWWWWWWWWWWWWWWDWWWWWWWDWWWDWWWWWWWDWWWWWWWDWWWWWWWWWWWWWWWDWWWWWWWWWWWWWWWWWWWWWWWWWWWWWWWWWWWWWWWWWWWWWWWWWWWWWWWWWWWWWWWWWWWWWWWWWWWWWWWWWW
W~~~.~~~W...W.&.W...W...W.$.W...W.$.W.$.W.$.W...W...W...W...W$..W...W...W...W...W...D...W...W...W...W...W...W...W...W...W...W...W...W...W...W...W...W...W...W...W...W...W...W...W...W...W...W...W...W...W...W
W~~~.~~~D.&.D.&.D...D...D...D...D...D...D...D...D...D...D...D...D.$.D...D...D...W.&.W.@.D...D...W.:.W...D...D...D...D...D...W...W...W...W...W...W...W...W...W...W...W...W...W...W...W...W...W...W...W...W...W
W~~~.~~~W.&.W...W...W.$.W...W.$.W...W...W...W.$.W...W..$W...W...W...W...W...W...D..&W...W...W...W...W...W...W...W...W...W...W...W...W...W...W...W...W...W...W...W...W...W...W...W...W...W...W...W...W...W...W
WWWWWWWWWWWWWWWWWWWWWWWWWWWWWWWWWWWWWWWWWWWWWWWWWWWWWWWWWWWWWWWWWWWWWWWWWWWWWWWWWWWWWWWWWWWWWWDWWWWWWWWWWWDWWWWWWWWWWWWWWWDWWWWWWWWWWWWWWWWWWWWWWWWWWWWWWWWWWWWWWWWWWWWWWWWWWWWWWWWWWWWWWWWWWWWWWWWWWWWWWWWWW
W...W...W...W...W...W...W...W...W...W...W...W...W...W...W...W...W...W...W...W...W...W...W.$.W...W...W...W...W...W...W...W...W...W...W...W...W...W...W...W...W...W...W...W...W...W...W...W...W...W...W...W...W
W...W...W...W...W...W...W...W...W...W...W...W...W...W...W...W...W...W...W...W...W.~.D...W~:.D...D...D.~.W...W...W...W...W...W...W...W...W...W...W...W...W...W...W...W...W...W...W...W...W...W...W...W...W...W
W...W...W...W...W...W...W...W...W...W...W...W...W...W...W...W...W...W...W...W...W...W...W.$.W...W...W...W...W...W...W...W...W...W...W...W...W...W...W...W...W...W...W...W...W...W...W...W...W...W...W...W...W
WWWWWWWWWWWWWWWWWWWWWWWWWWWWWWWWWWWWWWWWWWWWWWWWWWWWWWWWWWWWWWWWWWWWWWWWWWWWWWWWWWWWWWDWWWWWWWDWWWWWWWWWWWDWWWWWWWWWWWWWWWDWWWWWWWWWWWWWWWWWWWWWWWWWWWWWWWWWWWWWWWWWWWWWWWWWWWWWWWWWWWWWWWWWWWWWWWWWWWWWWWWWW
W...W...W...W...W...W...W...W...W...W...W...W...W...W...W...W...W...W...W...W...W...W...W...W...W...W...W...W...W...W...W...W...W...W...W...W...W...W...W...W...W...W...W...W...W...W...W...W...W...W...W...W
W...W...W...W...W...W...W...W...W...W...W...W...W...W...W...W...W...W...W...W...W...W...D...D...W...W...W...D...D...D...D...W...W...W...W...W...W...W...W...W...W...W...W...W...W...W...W...W...W...W...W...W
W...W...W...W...W...W...W...W...W...W...W...W...W...W...W...W...W...W...W...W...W...W...W...W...W...W...W...W...W...W...W...W...W...W...W...W...W...W...W...W...W...W...W...W...W...W...W...W...W...W...W...W
WWWWWWWWWWWWWWWWWWWWWWWWWWWWWWWWWWWWWWWWWWWWWWWWWWWWWWWWWWWWWWWWWWWWWWWWWWWWWWWWWWWWWWWWWWWWWWDWWWWWWWWWWWDWWWWWWWWWWWWWWWWWWWWWWWWWWWWWWWWWWWWWWWWWWWWWWWWWWWWWWWWWWWWWWWWWWWWWWWWWWWWWWWWWWWWWWWWWWWWWWWWWW
W...W...W...W...W...W...W...W...W...W...W...W...W...W...W...W...W...W...W...W...W...W...W...W...W...W...W...W...W...W...W...W...W...W...W...W...W...W...W...W...W...W...W...W...W...W...W...W...W...W...W...W
W...W...W...W...W...W...W...W...W...W...W...W...W...W...W...W...W...W...W...W...W...W...W...W...W...W...W...W...W...W...W...W...W...W...W...W...W...W...W...W...W...W...W...W...W...W...W...W...W...W...W...W
W...W...W...W...W...W...W...W...W...W...W...W...W...W...W...W...W...W...W...W...W...W...W...W...W...W...W...W...W...W...W...W...W...W...W...W...W...W...W...W...W...W...W...W...W...W...W...W...W...W...W...W
WWWWWWWWWWWWWWWWWWWWWWWWWWWWWWWWWWWWWWWWWWWWWWWWWWWWWWWWWWWWWWWWWWWWWWWWWWWWWWWWWWWWWWWWWWWWWWDWWWWWWWWWWWDWWWWWWWWWWWWWWWWWWWWWWWWWWWWWWWWWWWWWWWWWWWWWWWWWWWWWWWWWWWWWWWWWWWWWWWWWWWWWWWWWWWWWWWWWWWWWWWWWW
W...W...W...W...W...W...W...W...W...W...W...W...W...W...W...W...W...W...W...W...W...W...W...W...W...W...W...W...W...W...W...W...W...W...W...W...W...W...W...W...W...W...W...W...W...W...W...W...W...W...W...W
W...W...W...W...W...W...W...W...W...W...W...W...W...W...W...W...W...W...W...W...W...W...W...W...W...W...W...W...W...W...W...W...W...W...W...W...W...W...W...W...W...W...W...W...W...W...W...W...W...W...W...W
W...W...W...W...W...W...W...W...W...W...W...W...W...W...W...W...W...W...W...W...W...W...W...W...W...W...W...W...W...W...W...W...W...W...W...W...W...W...W...W...W...W...W...W...W...W...W...W...W...W...W...W
WWWWWWWWWWWWWWWWWWWWWWWWWWWWWWWWWWWWWWWWWWWWWWWWWWWWWWWWWWWWWWWWWWWWWWWWWWWWWWWWWWWWWWWWWWWWWWDWWWWWWWWWWWDWWWWWWWWWWWWWWWWWWWWWWWWWWWWWWWWWWWWWWWWWWWWWWWWWWWWWWWWWWWWWWWWWWWWWWWWWWWWWWWWWWWWWWWWWWWWWWWWWW
W...W...W...W...W...W...W...W...W...W...W...W...W...W...W...W...W...W...W...W...W...W...W...W...W...W...W...W...W...W...W...W...W...W...W...W...W...W...W...W...W...W...W...W...W...W...W...W...W...W...W...W
W...W...W...W...W...W...W...W...W...W...W...W...W...W...W...W...W...W...W...W...W...W...W...W...W...W...W...W...W...W...W...W...W...W...W...W...W...W...W...W...W...W...W...W...W...W...W...W...W...W...W...W
W...W...W...W...W...W...W...W...W...W...W...W...W...W...W...W...W...W...W...W...W...W...W...W...W...W...W...W...W...W...W...W...W...W...W...W...W...W...W...W...W...W...W...W...W...W...W...W...W...W...W...W
WWWWWWWWWWWWWWWWWWWWWWWWWWWWWWWWWWWWWWWWWWWWWWWWWWWWWWWWWWWWWWWWWWWWWWWWWWWWWWWWWWWWWWWWWWWWWWEWWWWWWWWWWWDWWWWWWWWWWWWWWWWWWWWWWWWWWWWWWWWWWWWWWWWWWWWWWWWWWWWWWWWWWWWWWWWWWWWWWWWWWWWWWWWWWWWWWWWWWWWWWWWWW
W...W...W...W...W...W...W...W...W...W...W...W...W...W...W...W...W...W...W...W...W...W...W...W...W...W...W...W...W...W...W...W...W...W...W...W...W...W...W...W...W...W...W...W...W...W...W...W...W...W...W...W
W...W...W...W...W...W...W...W...W...W...W...W...W...W...W...W...W...W...W...W...W...W...W...W.F.E...D...D...W...W...W...W...W...W...W...W...W...W...W...W...W...W...W...W...W...W...W...W...W...W...W...W...W
W...W...W...W...W...W...W...W...W...W...W...W...W...W...W...W...W...W...W...W...W...W...W...W...W...W...W...W...W...W...W...W...W...W...W...W...W...W...W...W...W...W...W...W...W...W...W...W...W...W...W...W
WWWWWWWWWWWWWWWWWWWWWWWWWWWWWWWWWWWWWWWWWWWWWWWWWWWWWWWWWWWWWWWWWWWWWWWWWWWWWWWWWWWWWWWWWWWWWWWWWWWWWWWWWWWWWWWWWWWWWWWWWWWWWWWWWWWWWWWWWWWWWWWWWWWWWWWWWWWWWWWWWWWWWWWWWWWWWWWWWWWWWWWWWWWWWWWWWWWWWWWWWWWWW
