WWWWWWWWWWWWWWWWWWWWWWWWW
W...W.~.W...W...D...D...W
W.@.d...d...e...D...D..WW
W...W..-W...W...D...D.WEW
WWWWWWDWWWDWWWWWWWWWWWWWW
W-:-W...W...W...D...D...W
W:.-D...D...W...D...E...W
W;~.W;..W...W...D...D...W
WWWWWWWWWWWWWWWWWWWWWWWWW
