WWWWWWWWWWEWWWWWWWWWWWWWW
W:..W.~.W...W...D...DdCeW
W.@.d...d...e...D...DhWWW
W...W..-W...W...D...DDWEW
WWWWWWDWWWDWWWWWWWWWWWWWW
W-:;W...W...W.@.D...D...W
W:;-D...D...W.@.D...D...W
W;~:W;..W...W.@.D...D...W
WWWWWWWWWWWWWWWWWWWWWWWWW
