WWWWWWWWW
W~..W...W
W@..E.F.W
W..:W...W
WWWWWWWWW
