WWWWWWWWWWWWW
W~..W.:.W$$$W
W...D...D..$W
W..&W..:W$$$W
WWWWWWDWWWWWW
W:..W.@.W...W
W..&D.&.E.F.W
W..&W:..W...W
WWWWWWWWWWWWW
