W;WWWWWWWWWWWWWWWWWWWWWWW
W...W.~.d...d...D...D...W
W.@.d...W...e...d...d..WW
W..dW..-d...d...D...D.WEW
WdWWWWdWWdDWWdWdWWdWWWWWW
W-:-W...W...W...D...D...W
W:.-D...D...D...D...E...W
W;~.W;..W...W...D...D...W
WdWWWWdWWWDWWdWdWWdWWWWWW
W-:-W...W...d...D...D...W
W:.-D...D...W...D...E...W
W;~.W;..W...W...D...D...W
WWWWWWWWWWWWWWWWWWWWWWWWW
