WWWWWWWWWWEWW
W-..W.?.W...W
W.@.D...D...W
W...W..?W...W
WWWWWWDWWWDWW
W?..W...W...W
W...D...D.!.W
W...W?..W...W
wwwwwwwwwwwww
