WWWWWWWWW
W...W...W
W...D...W
W...W...W
WWDWWWDWW
W...W...W
W...W...W
W...W.:FW
WWDWWWDWW
W...W...W
W...D...W
W...W...W
WWDWWWDWW
W...W.W.W
W...DW..W
W...W...W
WWWWWWWWW
