WWWWWWWWWWWWWWWWWWWWWWWWWWWWWWWWWWWWWWWWWWWWWW
W.~..W.:..W....W....W....W....W....W.&..W....W
W....D....D.D..D....D....D....D....D....W....W
W.@..W....&.:..W....W..:.W....W.:..W.$..W....W
WWWWWWDWW$WWWWWWDWWWWWWWWWWWWWWWWWWWWWWWWWWWWW
W....W....W.:..W....W.:..W....W.:..W....W.E.FW
W....D..&.D....D....D....D.$..D....D....D....W
W.:..W....W....W....W....W....W....W..:.W....W
WWWWWWWWWWWWWWWWWWWWWWWWWWWWWWWWWWWWWWWWWWWWWW
