WWWWWWWWWWWWWWWWWWWWWWWWWWWWWWWWWWWWWWWWWWWWWW
W.~..W.:..W....W....W....W....W....W.&..W....W
W....D....D....D....D....D....D....D....W....W
W.@..W....W.:..W....W..:.W....W.:..W.$..W....W
WWWWWWDWWWWWWWWWDWWWWWWWWDWWWWWWWWWWWWWWWWWWWW
W....W....W....W.:..W....W....W.:..W....W....W
W....D..&.D....D....D....D.$..D....D....W....W
W.:..W....W.:..W....W.:..W....W....W....W..:.W
WWWWWWWWWWWWWWWWWWWWWWWWWWDWWWWWWWWDWWWWWWWWWW
W....W....W....W.:..W....W....W.:..W....W....W
W....D....D.$..D....D..&.D....D....D....W....W
W.:..W....W....W....W....W.:..W....W.$..W....W
WWWWWWDWWWWWWWWWDWWWWWWWWWWWWWWWWWWWWWWWWWWWWW
W....W....W.:..W....W.:..W....W.:..W....W.E.FW
W....D..&.D....D....D....D.$..D....D....W....W
W.:..W....W....W....W....W....W....W..:.W....W
WWWWWWWWWWWWWWWWWWWWWWWWWWWWWWWWWWWWWWWWWWWWWW
