WWWWWWWWW
W...W...W
W.@WD...W
W.W.W...W
WWDW$W:WW
W...W...W
W...:...W
W...W.:FW
WWDWWWDWW
W...W...W
W...&...W
W...W...W
WWDWWWDWW
W...W.W.W
W...DW..W
W...W...W
WWWWWWWWW
