WWWWWWWWWWWWWWWWWWWWW
W...WWWWWWWWWWWWW...W
W.@.WWWWWWWWWWWWW.F.W
W...WWWWWWWWWWWWW...W
WWDWWWWWWWWWWWWWWWEWW
W...W&.&W...W.$.W...W
W.~.D...D.:.D...D.:.W
W~..W&.&W...W.$.W~.~W
WWWWWWWWWWWWWWWWWWWWW
