WWWWWWWWW
W...W...W
W.&.D.$.W
W..&W...W
WWDWWWDWW
W&.&W...W
W&.&W.~.W
W&.&W...W
WWDWWWDWW
W&..W..&W
W~&.W.&~W
W&.&W&.&W
WWDWWWDWW
W...W...W
W.&.W.:.W
W...W...W
WWDWWWEWW
W...W...W
W.@.E.F.W
W...W...W
WWDWWWEWW
W...W...W
W&&&W.:.W
W...W...W
WWDWWWDWW
W&..W..&W
W.&.D.&.W
W..&W&..W
WWDWWWDWW
WW~WWW.WW
WW~WWW.:W
WW$WWWWWW
WWWWWWWWW
